========================================
|>|             |              =====|  |
|               |  |                |  |
| |=  ===  == = |  |=========       |  |
|               |  |        | |     |  |
|========       |           | |     |  |
||      |       |======     | |     |  |
||      |     |       |     | |     |  |
||      |   | |====         | |        |
||      |   | |             | |        |
|       |             |==  ===|  |==|  |
|       |       |     |     | |     |  |
|       |             |     | |  |==|  |
|       |===========  |  ===|  |       |
|                  |  |==|     ===|    |
|   |              |  |           |    |
| ==|  |=|         |  |      |    |    |
| |   =| =|        |==|   |  |===      |
| |==     |               |        |   |
=====|<|================================